blue: B, 0
red: R,
green: G,
cyan: C,
magenta: M,
orange: O,
pink: P,
yellow: Y
++++++++++++++++++
+BBRRGGCCMMOOPPYY+
+                +
+                +
+        0       +
+                +
+                +
+ b r g c m o p y+
+ b r g c m o p y+
++++++++++++++++++
