+++++++++++++++++++
+               +++
+     +R+++O+    ++
++    ++++++++    +
 ++   +++++++O    +
  +   ++++++++    +
  +   +B+++T+    ++
  +            ++++
  +   +robot+    ++
  +   +++++++    0+
  +++++++++++++++++
